butikk : Laden, Geschäft
gård : Hof, Bauernhof
få : bekommen
god : gut, lecker
frisk : frisch
grønnsak : Gemüse
stor : groß
potet : Kartoffel
egg : Ei
lykkelig : glücklich
høne : Huhn
noen : einige
deilig : lecker, herrlich
syltetøy : Konfitüre
eplesong : Apfelsaison
rød : rot
eple : Apfel
sulten : hungrig
tørst : Durst
drikke : trinken
pris : Preis
kanskje : vielleicht
grønnsakssuppe : Gemüsesuppe
varm : warm, heiß
rundstykke : Brötchen
stykke : Stück
eplekake : Apfelkuchen
kake : Kuchen
krem : Schlagsahne
kopp : Tasse
hver : jede, jeder
lørdag : Samstag
alltid : immer
dessert : Nachtisch
fri : frei
lage mat : kochen
biff : Steak
løk : Zwiebel
potetgrateng : Kartoffelgratin
steke : braten
skjarere : schneiden
gram : Gramm
nok : genug
to : zwei
spørsmål : Frage
dum : dumm, blöd
da : da, dann
tyttebaer : Preiselbeere
ris : Reis
denne : dieser, diese
disse : diese
dette : dieses
til : für
fire : vier
to og en halv : zweieinhalb
desiliter : Deziliter
fløte : Sahne
hvor mye : Wie viel
koke : kochen, sieden
la : lassen
kald : kalt
av : von
blande : mischen
legge : legen
lagvis : schichtweise
bolle : Schüssel
vanskelig : schwierig
gi : geben
pakke : Packung
der : dort
kniv : Messer
se ut : aussehen
gråte : weinen
rekke : strecken
tulle : spinnen, Unsinn reden
pleie å : pflegen zu, normalerweise tun
time : Stunde
siden : seit
frokost : Frühstück
hvor mange : Wie viele
var : war, warst, waren, wart
klokke : Uhr
vanligvis : normalerweise
bare : nur
gjøre : machen, tun
sende : reichen
mett : satt
mage : Bauch, Magen