Obs : Achtung
du : du
er : bin, bist, ist, sind, seid
vaere : sein
viktig : wichtig
vi : wir
snakke : sprechen
med : mit
hverandre : einander
ikke : nicht
om : von, über
det : es, das
hete : heißen
dere : ihr, euch
ha : haben
en : ein
ei : eine
et : ein
problem : problem
løse : lösen
sammen : zusammen
gjest : Gast
prioritet : Priorität
de : sie
person : Person
svare : antworten
umulig : unmöglich
han : er
eller : oder
hun : sie
alt : alles
mulig : möglich
jeg : ich
prøve : probieren
smile : lächeln
till : an, zu, nach
verden : Welt
og : und
tilbake : zurück
tro : glauben
gal : verrückt
velkommen : willkommen
oss : uns
ny : neu
resepsjonist : Rezeptionist
på : auf, in
hotell : Hotel
sjef : Chef
hei : Hallo
tusen : Tausend
takk : Dank
hvordan : wie
gå : gehen
bra : gut, schön
bli : werden
hyygelig : nett
å : zu
jobbe : arbeiten
dette : dies
også : auch
her : hier
forklare : erklären
deg : dich, dir
treffe : treffen
kjenne : kennen
ja : ja
egentlig : eigentlich
fra : von, aus
nå : nun, jetzt
etter : nach
lang : lang
tid : Zeit
i : in
Oslo : Oslo
bo : wohnen
hos : bei
venninne : Freundin
henne : sie, ihr
men : aber
trenge : brauchen
hus : Haus
leilighet : Wohnung
venn : Freund
nei : nein
unnskyld : entschuldige
meg : mich, mir
hva : was
igjen : wieder
hvor : wo
komme : kommen
kokk : Koch, Köchin
ham : ihn, ihm
skoletida : Schulzeit
mene : meinen
