hjemmeside : homepage
sjarm : Charme
midt : mitten
gågate : Fußgängerzone
nærhet : Nähe
tog : Zug
buss : Bus
restaurant : Restaurant
spesialitet : Spezialität
region : Region
alle : alle
rettighet : Schankerlaubnis
shoppingmulighet : Einkaufsmöglichkeit
ligge : liegen
rett : direkt, gerade
utenfor : außerhalb
dør : Tür
mange : viele
severdighet : Sehenswürdigkeiten
aktivitet : Aktivität
for : für
kurslokale : Kursraum
koferanselokale : Konferenzraum
kontakt : Kontakt
fjell : Berg, Gebirge
ringe : klingeln, anrufen
ta : nehmen
telefon : Telefon
kunne : können
norsk : norwegisch
så : so
mye : viel
engelsk : englisch
jo : doch
naturligvis : selbstverständlich
hjelpe : helfen
ville : wollen
gjerne : gern
vite : wissen
litt : ein bisschen
uff : oje
stemme : stimmen
se : sehen
man : man
dessverre : leider
ganske : ziemlich
rolig : ruhig
spise : essen
vegetarmat : vegetarisches Essen
mat : Essen
sikker : sicher
senere : später
ringe tilbake : zurückrufen
lage : machen, herstellen, kochen
kjempe- : sehr
forresten : übrigens
lese : lesen
mer : mehr
se på : anschauen
sende : senden, schicken
den : er, ihm, ihn, sie, ihr
e-post : E-Mail
adresse : Adresse
stave : buchstabieren
bindestrek : Bindestrich
@(krølalfa) : at
virkelig : wirklich
tysk : deutsch
lærebok : Lehrbuch
hjemme : zuhause
bok : Buch
på norsk : auf norwegisch
ofte : oft
ferie : Ferien
på ferie : in den Ferien
Norge : Norwegen
elg : Elch
gang : Mal
en gang : einmal
i det minste : wenigstens
barbarisk : barbarisch
